!/#/...#/>
..#./..#..
..#../.#..
..#.../#..
..........
..........
..........
..........
..........
..........
..........
..........
..........
..........
..........
..........