!/#/...#/>
..#./..#..
..#../.#..
/.#.../#./
..........
..........
..........
..........
..........
..........
..........
..........
..........
..........
..........
..........