!.../.>.#..
...../.....
....../.#..
......./#..
........#..
...........
...........
...........
........#..
........#..
........#..
........#..